Area_Code,Area,Region_Code,Region,Electorate,Votes_Cast,Valid_Votes,Remain,Leave,Rejected_Ballots,No_official_mark,Voting_for_both_answers,Writing_or_mark,Unmarked_or_void
E06000031,Peterborough,E12000006,East,120892,87469,87392,34176,53216,77,0,32,7,38
E06000032,Luton,E12000006,East,127612,84616,84481,36708,47773,135,0,85,0,50
E06000033,Southend-on-Sea,E12000006,East,128856,93939,93870,39348,54522,69,0,21,0,48
E06000034,Thurrock,E12000006,East,109897,79950,79916,22151,57765,34,0,8,3,23
E06000055,Bedford,E12000006,East,119530,86135,86066,41497,44569,69,0,26,1,42
E06000056,Central Bedfordshire,E12000006,East,204004,158894,158804,69670,89134,90,0,34,1,55
E07000008,Cambridge,E12000006,East,80108,57852,57799,42682,15117,53,0,13,0,40
E07000009,East Cambridgeshire,E12000006,East,62435,48124,48086,23599,24487,38,0,18,0,20
E07000010,Fenland,E12000006,East,71447,52649,52626,15055,37571,23,0,10,1,12
E07000011,Huntingdonshire,E12000006,East,128486,99990,99927,45729,54198,63,0,31,0,32
E07000012,South Cambridgeshire,E12000006,East,114830,93250,93189,56128,37061,61,0,24,0,37
E07000066,Basildon,E12000006,East,132771,98062,97999,30748,67251,63,3,26,2,32
E07000067,Braintree,E12000006,East,112562,86303,86236,33523,52713,67,0,23,0,44
E07000068,Brentwood,E12000006,East,58777,46725,46704,19077,27627,21,0,3,1,17
E07000069,Castle Point,E12000006,East,68860,51909,51845,14154,37691,64,0,15,1,48
E07000070,Chelmsford,E12000006,East,129971,100852,100794,47545,53249,58,0,23,2,33
E07000071,Colchester,E12000006,East,127520,95782,95719,44414,51305,63,2,17,5,39
E07000072,Epping Forest,E12000006,East,100016,76900,76852,28676,48176,48,0,21,2,25
E07000073,Harlow,E12000006,East,59124,43489,43469,13867,29602,20,0,1,0,19
E07000074,Maldon,E12000006,East,49073,38850,38831,14529,24302,19,1,9,1,8
E07000075,Rochford,E12000006,East,66589,52479,52447,17510,34937,32,0,13,1,18
E07000076,Tendring,E12000006,East,111167,82703,82657,25210,57447,46,0,17,2,27
E07000077,Uttlesford,E12000006,East,64735,51972,51943,25619,26324,29,0,5,0,24
E07000095,Broxbourne,E12000006,East,68997,50907,50872,17166,33706,35,0,14,0,21
E07000096,Dacorum,E12000006,East,108965,86307,86244,42542,43702,63,4,24,0,35
E07000098,Hertsmere,E12000006,East,73295,56159,56125,27593,28532,34,0,12,0,22
E07000099,North Hertfordshire,E12000006,East,99316,77737,77672,42234,35438,65,0,29,1,35
E07000102,Three Rivers,E12000006,East,67380,52896,52848,25751,27097,48,4,15,4,25
E07000103,Watford,E12000006,East,65060,46635,46586,23167,23419,49,0,23,4,22
E07000143,Breckland,E12000006,East,98989,73593,73548,26313,47235,45,0,10,0,35
E07000144,Broadland,E12000006,East,99254,77781,77737,35469,42268,44,0,0,0,44
E07000145,Great Yarmouth,E12000006,East,72634,50158,50128,14284,35844,30,0,14,7,9
E07000146,King's Lynn and West Norfolk,E12000006,East,113884,85128,85080,28587,56493,48,0,13,3,32
E07000147,North Norfolk,E12000006,East,83065,63829,63790,26214,37576,39,0,4,2,33
E07000148,Norwich,E12000006,East,96091,66422,66366,37326,29040,56,0,17,1,38
E07000149,South Norfolk,E12000006,East,102395,80418,80358,38817,41541,60,0,24,1,35
E07000200,Babergh,E12000006,East,70628,55272,55242,25309,29933,30,0,13,0,17
E07000201,Forest Heath,E12000006,East,38527,27977,27951,9791,18160,26,2,4,2,18
E07000202,Ipswich,E12000006,East,91574,66400,66353,27698,38655,47,0,1,7,39
E07000203,Mid Suffolk,E12000006,East,78325,61222,61185,27391,33794,37,0,4,0,33
E07000204,St Edmundsbury,E12000006,East,81148,62255,62210,26986,35224,45,1,14,0,30
E07000205,Suffolk Coastal,E12000006,East,98195,79226,79184,37218,41966,42,0,15,3,24
E07000206,Waveney,E12000006,East,90391,65687,65646,24356,41290,41,0,11,0,30
E07000240,St Albans,E12000006,East,104859,86524,86445,54208,32237,79,0,31,0,48
E07000241,Welwyn Hatfield,E12000006,East,78146,58641,58610,27550,31060,31,0,10,0,21
E07000242,East Hertfordshire,E12000006,East,106260,85433,85366,42372,42994,67,0,26,5,36
E07000243,Stevenage,E12000006,East,62156,45811,45785,18659,27126,26,0,12,2,12
E06000015,Derby,E12000004,East Midlands,171246,120772,120655,51612,69043,117,0,41,10,66
E06000016,Leicester,E12000004,East Midlands,213819,139307,138972,70980,67992,335,0,154,8,173
E06000017,Rutland,E12000004,East Midlands,29390,22984,22966,11353,11613,18,0,9,2,7
E06000018,Nottingham,E12000004,East Midlands,195394,120791,120661,59318,61343,130,0,47,4,79
E07000032,Amber Valley,E12000004,East Midlands,96760,73864,73820,29319,44501,44,0,7,1,36
E07000033,Bolsover,E12000004,East Midlands,58063,41999,41972,12242,29730,27,0,5,1,21
E07000034,Chesterfield,E12000004,East Midlands,79905,57470,57424,22946,34478,46,0,16,2,28
E07000035,Derbyshire Dales,E12000004,East Midlands,57075,46756,46728,22633,24095,28,0,5,0,23
E07000036,Erewash,E12000004,East Midlands,87596,66566,66530,25791,40739,36,0,15,1,20
E07000037,High Peak,E12000004,East Midlands,72487,54864,54833,27116,27717,31,0,10,3,18
E07000038,North East Derbyshire,E12000004,East Midlands,78855,59341,59310,22075,37235,31,0,13,2,16
E07000039,South Derbyshire,E12000004,East Midlands,73856,56718,56695,22479,34216,23,0,5,0,18
E07000129,Blaby,E12000004,East Midlands,73832,56512,56471,22888,33583,41,0,13,2,26
E07000130,Charnwood,E12000004,East Midlands,133780,94257,94172,43500,50672,85,0,47,0,38
E07000131,Harborough,E12000004,East Midlands,67420,54910,54878,27028,27850,32,0,1,2,29
E07000132,Hinckley and Bosworth,E12000004,East Midlands,85305,65516,65470,25969,39501,46,0,6,0,40
E07000133,Melton,E12000004,East Midlands,37273,30327,30305,12695,17610,22,0,9,1,12
E07000134,North West Leicestershire,E12000004,East Midlands,73944,57638,57611,22642,34969,27,0,6,0,21
E07000135,Oadby and Wigston,E12000004,East Midlands,42684,31489,31465,14292,17173,24,0,9,0,15
E07000136,Boston,E12000004,East Midlands,39363,30416,30404,7430,22974,12,0,1,1,10
E07000137,East Lindsey,E12000004,East Midlands,107009,80178,80128,23515,56613,50,2,21,0,27
E07000138,Lincoln,E12000004,East Midlands,63351,43928,43894,18902,24992,34,0,17,0,17
E07000139,North Kesteven,E12000004,East Midlands,86468,67791,67753,25570,42183,38,0,13,1,24
E07000140,South Holland,E12000004,East Midlands,65701,49518,49497,13074,36423,21,0,8,0,13
E07000141,South Kesteven,E12000004,East Midlands,105457,82523,82471,33047,49424,52,0,14,4,34
E07000142,West Lindsey,E12000004,East Midlands,73499,54781,54753,20906,33847,28,0,7,4,17
E07000150,Corby,E12000004,East Midlands,43313,32097,32081,11470,20611,16,0,4,0,12
E07000151,Daventry,E12000004,East Midlands,61004,49420,49381,20443,28938,39,0,10,2,27
E07000152,East Northamptonshire,E12000004,East Midlands,68334,52607,52574,21680,30894,33,0,6,2,25
E07000153,Kettering,E12000004,East Midlands,70570,53940,53907,21030,32877,33,1,12,0,20
E07000154,Northampton,E12000004,East Midlands,144948,105354,105259,43805,61454,95,0,35,7,53
E07000155,South Northamptonshire,E12000004,East Midlands,71309,56664,56624,25853,30771,40,0,18,1,21
E07000156,Wellingborough,E12000004,East Midlands,54572,41178,41141,15462,25679,37,0,18,2,17
E07000170,Ashfield,E12000004,East Midlands,91916,66946,66899,20179,46720,47,1,15,1,30
E07000171,Bassetlaw,E12000004,East Midlands,85547,64003,63967,20575,43392,36,1,10,5,20
E07000172,Broxtowe,E12000004,East Midlands,83593,65468,65426,29672,35754,42,0,8,1,33
E07000173,Gedling,E12000004,East Midlands,88298,67635,67577,30035,37542,58,2,17,1,38
E07000174,Mansfield,E12000004,East Midlands,77624,56370,56344,16417,39927,26,0,8,0,18
E07000175,Newark and Sherwood,E12000004,East Midlands,87338,67128,67087,26571,40516,41,0,14,2,25
E07000176,Rushcliffe,E12000004,East Midlands,86401,70470,70410,40522,29888,60,0,20,0,40
E09000001,City of London,E12000007,London,5987,4405,4399,3312,1087,6,0,2,0,4
E09000002,Barking and Dagenham,E12000007,London,115812,73941,73880,27750,46130,61,0,21,0,40
E09000003,Barnet,E12000007,London,223467,161218,161033,100210,60823,185,0,54,12,119
E09000004,Bexley,E12000007,London,170779,128570,128489,47603,80886,81,5,35,0,41
E09000005,Brent,E12000007,London,186793,121671,121404,72523,48881,267,0,157,0,110
E09000006,Bromley,E12000007,London,231473,182570,182432,92398,90034,138,0,43,0,95
E09000007,Camden,E12000007,London,145425,95281,95133,71295,23838,148,0,54,8,86
E09000008,Croydon,E12000007,London,245349,171289,171134,92913,78221,155,0,73,5,77
E09000009,Ealing,E12000007,London,212991,149268,149041,90024,59017,227,0,115,3,109
E09000010,Enfield,E12000007,London,198387,137056,136906,76425,60481,150,0,69,1,80
E09000011,Greenwich,E12000007,London,168967,117470,117365,65248,52117,105,0,35,1,69
E09000012,Hackney,E12000007,London,163284,106422,106266,83398,22868,156,7,44,35,70
E09000013,Hammersmith and Fulham,E12000007,London,114863,80347,80242,56188,24054,105,0,32,8,65
E09000014,Haringey,E12000007,London,150098,106032,105846,79991,25855,186,0,71,0,115
E09000015,Harrow,E12000007,London,162397,117352,117225,64042,53183,127,0,50,6,71
E09000016,Havering,E12000007,London,183082,139175,139086,42201,96885,89,1,25,1,62
E09000017,Hillingdon,E12000007,London,193033,133170,133022,58040,74982,148,0,55,16,77
E09000018,Hounslow,E12000007,London,165050,115208,115076,58755,56321,132,0,39,6,87
E09000019,Islington,E12000007,London,144514,101723,101600,76420,25180,123,0,47,2,74
E09000020,Kensington and Chelsea,E12000007,London,83042,54801,54739,37601,17138,62,0,14,2,46
E09000021,Kingston upon Thames,E12000007,London,108838,85330,85270,52533,32737,60,0,16,3,41
E09000022,Lambeth,E12000007,London,210800,142162,141924,111584,30340,238,0,104,0,134
E09000023,Lewisham,E12000007,London,197514,124637,124473,86955,37518,164,0,61,1,102
E09000024,Merton,E12000007,London,136352,100207,100100,63003,37097,107,0,45,0,62
E09000025,Newham,E12000007,London,176985,104864,104699,55328,49371,165,9,87,0,69
E09000026,Redbridge,E12000007,London,189843,128397,128233,69213,59020,164,0,78,3,83
E09000027,Richmond upon Thames,E12000007,London,132632,108876,108806,75396,33410,70,0,26,2,42
E09000028,Southwark,E12000007,London,195875,129677,129502,94293,35209,175,0,60,5,110
E09000029,Sutton,E12000007,London,140288,106633,106560,49319,57241,73,0,25,7,41
E09000030,Tower Hamlets,E12000007,London,167820,108420,108235,73011,35224,185,0,105,6,74
E09000031,Waltham Forest,E12000007,London,162983,108689,108551,64156,44395,138,4,44,9,81
E09000032,Wandsworth,E12000007,London,219521,158018,157884,118463,39421,134,0,55,0,79
E09000033,Westminster,E12000007,London,120524,78325,78196,53928,24268,129,0,47,1,81
E06000001,Hartlepool,E12000001,North East,70341,46134,46100,14029,32071,34,0,12,6,16
E06000002,Middlesbrough,E12000001,North East,94612,61393,61358,21181,40177,35,0,16,1,18
E06000003,Redcar and Cleveland,E12000001,North East,103529,72741,72714,24586,48128,27,0,6,0,21
E06000004,Stockton-on-Tees,E12000001,North East,141486,100460,100415,38433,61982,45,2,13,2,28
E06000005,Darlington,E12000001,North East,77662,55195,55166,24172,30994,29,0,0,0,29
E06000047,County Durham,E12000001,North East,389507,267546,267398,113521,153877,148,3,35,1,109
E06000057,Northumberland,E12000001,North East,240496,178815,178721,82022,96699,94,3,30,6,55
E08000021,Newcastle upon Tyne,E12000001,North East,190735,129072,129003,65405,63598,69,0,20,5,44
E08000022,North Tyneside,E12000001,North East,156993,113507,113462,52873,60589,45,0,17,3,25
E08000023,South Tyneside,E12000001,North East,115893,79117,79079,30014,49065,38,0,10,1,27
E08000024,Sunderland,E12000001,North East,207221,134400,134324,51930,82394,76,0,13,2,61
E08000037,Gateshead,E12000001,North East,145866,103007,102958,44429,58529,49,0,13,3,33
E06000006,Halton,E12000002,North West,95289,65047,65005,27678,37327,42,0,7,1,34
E06000007,Warrington,E12000002,North West,157042,115205,115144,52657,62487,61,0,17,1,43
E06000008,Blackburn with Darwen,E12000002,North West,100117,65408,65321,28522,36799,87,0,40,4,43
E06000009,Blackpool,E12000002,North West,102354,66959,66927,21781,45146,32,0,8,3,21
E06000049,Cheshire East,E12000002,North West,285957,221229,221125,107962,113163,104,19,40,3,42
E06000050,Cheshire West and Chester,E12000002,North West,259878,193633,193537,95455,98082,96,0,27,11,58
E07000026,Allerdale,E12000002,North West,74426,54268,54238,22429,31809,30,0,13,0,17
E07000027,Barrow-in-Furness,E12000002,North West,53194,36101,36074,14207,21867,27,0,9,0,18
E07000028,Carlisle,E12000002,North West,80124,59721,59683,23788,35895,38,0,13,2,23
E07000029,Copeland,E12000002,North West,54206,37975,37947,14419,23528,28,0,9,3,16
E07000030,Eden,E12000002,North West,41872,31746,31718,14807,16911,28,0,12,1,15
E07000031,South Lakeland,E12000002,North West,81948,65375,65331,34531,30800,44,0,12,2,30
E07000117,Burnley,E12000002,North West,64461,43350,43316,14462,28854,34,0,11,0,23
E07000118,Chorley,E12000002,North West,84159,63560,63515,27417,36098,45,4,6,5,30
E07000119,Fylde,E12000002,North West,61174,46227,46206,19889,26317,21,0,5,1,15
E07000120,Hyndburn,E12000002,North West,62042,40168,40137,13569,26568,31,0,13,3,15
E07000121,Lancaster,E12000002,North West,100567,73098,73041,35732,37309,57,0,12,2,43
E07000122,Pendle,E12000002,North West,64534,45388,45335,16704,28631,53,0,15,7,31
E07000123,Preston,E12000002,North West,94284,64794,64745,30227,34518,49,2,19,0,28
E07000124,Ribble Valley,E12000002,North West,46148,36466,36442,15892,20550,24,3,6,1,14
E07000125,Rossendale,E12000002,North West,52750,38205,38181,15012,23169,24,0,9,1,14
E07000126,South Ribble,E12000002,North West,84573,63755,63724,26406,37318,31,0,15,2,14
E07000127,West Lancashire,E12000002,North West,85834,63918,63869,28546,35323,49,0,13,1,35
E07000128,Wyre,E12000002,North West,84471,63028,62979,22816,40163,49,3,19,8,19
E08000001,Bolton,E12000002,North West,197109,138180,138080,57589,80491,100,2,43,2,53
E08000002,Bury,E12000002,North West,141600,101144,101028,46354,54674,116,0,34,10,72
E08000003,Manchester,E12000002,North West,338064,202067,201814,121823,79991,253,0,78,0,175
E08000004,Oldham,E12000002,North West,158084,107493,107403,42034,65369,90,0,24,2,64
E08000005,Rochdale,E12000002,North West,156621,103319,103231,41217,62014,88,0,48,2,38
E08000006,Salford,E12000002,North West,173668,109926,109815,47430,62385,111,0,34,4,73
E08000007,Stockport,E12000002,North West,221162,163584,163489,85559,77930,95,0,27,4,64
E08000008,Tameside,E12000002,North West,168047,111016,110947,43118,67829,69,0,14,5,50
E08000009,Trafford,E12000002,North West,165294,125400,125311,72293,53018,89,0,23,5,61
E08000010,Wigan,E12000002,North West,235982,163381,163273,58942,104331,108,7,32,2,67
E08000011,Knowsley,E12000002,North West,111647,70937,70903,34345,36558,34,4,14,1,15
E08000012,Liverpool,E12000002,North West,317924,203728,203554,118453,85101,174,0,60,4,110
E08000013,St. Helens,E12000002,North West,136096,93721,93679,39322,54357,42,0,13,3,26
E08000014,Sefton,E12000002,North West,206298,147970,147878,76702,71176,92,0,26,0,66
E08000015,Wirral,E12000002,North West,242568,172137,172000,88931,83069,137,0,31,4,102
N92000002,Northern Ireland,N92000002,Northern Ireland,1260955,790523,790149,440707,349442,374,18,148,1,207
S12000005,Clackmannanshire,S92000003,Scotland,37841,25439,25427,14691,10736,12,0,6,0,6
S12000006,Dumfries and Galloway,S92000003,Scotland,115837,82715,82667,43864,38803,48,0,13,1,34
S12000008,East Ayrshire,S92000003,Scotland,91977,57859,57833,33891,23942,26,0,8,0,18
S12000010,East Lothian,S92000003,Scotland,77788,55800,55764,36026,19738,36,0,12,0,24
S12000011,East Renfrewshire,S92000003,Scotland,69575,52969,52941,39345,13596,28,0,7,0,21
S12000013,Eilean Siar,S92000003,Scotland,21259,14919,14903,8232,6671,16,0,3,0,13
S12000014,Falkirk,S92000003,Scotland,117392,79302,79258,44987,34271,44,0,7,2,35
S12000015,Fife,S92000003,Scotland,272995,182307,182220,106754,75466,87,2,29,4,52
S12000017,Highland,S92000003,Scotland,175563,125728,125657,70308,55349,71,0,27,2,42
S12000018,Inverclyde,S92000003,Scotland,58624,38722,38698,24688,14010,24,0,6,0,18
S12000019,Midlothian,S92000003,Scotland,66758,45497,45468,28217,17251,29,0,8,0,21
S12000020,Moray,S92000003,Scotland,71370,48139,48106,24114,23992,33,0,16,3,14
S12000021,North Ayrshire,S92000003,Scotland,104572,67548,67504,38394,29110,44,0,16,0,28
S12000023,Orkney Islands,S92000003,Scotland,16658,11402,11382,7189,4193,20,0,8,0,12
S12000024,Perth and Kinross,S92000003,Scotland,110224,81294,81255,49641,31614,39,1,14,0,24
S12000026,Scottish Borders,S92000003,Scotland,88440,64953,64914,37952,26962,39,0,14,0,25
S12000027,Shetland Islands,S92000003,Scotland,17375,12231,12222,6907,5315,9,0,2,0,7
S12000028,South Ayrshire,S92000003,Scotland,88116,61542,61506,36265,25241,36,0,14,2,20
S12000029,South Lanarkshire,S92000003,Scotland,248949,162683,162592,102568,60024,91,0,30,1,60
S12000030,Stirling,S92000003,Scotland,66100,48931,48899,33112,15787,32,0,11,1,20
S12000033,Aberdeen City,S92000003,Scotland,154266,104809,104714,63985,40729,95,0,34,2,59
S12000034,Aberdeenshire,S92000003,Scotland,196809,139014,138961,76445,62516,53,0,19,1,33
S12000035,Argyll and Bute,S92000003,Scotland,66642,48734,48696,29494,19202,38,0,16,1,21
S12000036,City of Edinburgh,S92000003,Scotland,346073,252481,252294,187796,64498,187,0,71,1,115
S12000038,Renfrewshire,S92000003,Scotland,127294,88197,88129,57119,31010,68,0,17,5,46
S12000039,West Dunbartonshire,S92000003,Scotland,67595,43245,43220,26794,16426,25,0,9,0,16
S12000040,West Lothian,S92000003,Scotland,130925,88556,88508,51560,36948,48,0,22,2,24
S12000041,Angus,S92000003,Scotland,87137,59282,59258,32747,26511,24,0,9,1,14
S12000042,Dundee City,S92000003,Scotland,105554,66418,66385,39688,26697,33,0,12,0,21
S12000044,North Lanarkshire,S92000003,Scotland,254567,155045,154949,95549,59400,96,2,19,2,73
S12000045,East Dunbartonshire,S92000003,Scotland,83031,62418,62374,44534,17840,44,0,7,0,37
S12000046,Glasgow City,S92000003,Scotland,449806,253000,252809,168335,84474,191,1,67,7,116
E06000035,Medway,E12000008,South East,192524,138973,138886,49889,88997,87,0,27,9,51
E06000036,Bracknell Forest,E12000008,South East,85298,64922,64890,29888,35002,32,0,10,0,22
E06000037,West Berkshire,E12000008,South East,116757,93345,93277,48300,44977,68,0,27,4,37
E06000038,Reading,E12000008,South East,103172,74826,74767,43385,31382,59,0,32,0,27
E06000039,Slough,E12000008,South East,87873,54598,54542,24911,29631,56,1,32,2,21
E06000040,Windsor and Maidenhead,E12000008,South East,102665,81855,81792,44086,37706,63,0,14,2,47
E06000041,Wokingham,E12000008,South East,121891,97551,97501,55272,42229,50,0,23,2,25
E06000042,Milton Keynes,E12000008,South East,177211,130534,130456,63393,67063,78,0,32,1,45
E06000043,Brighton and Hove,E12000008,South East,198293,146829,146675,100648,46027,154,0,49,6,99
E06000044,Portsmouth,E12000008,South East,140517,98786,98720,41384,57336,66,0,27,0,39
E06000045,Southampton,E12000008,South East,158171,107775,107665,49738,57927,110,0,42,25,43
E06000046,Isle of Wight,E12000008,South East,109844,79430,79380,30207,49173,50,0,24,2,24
E07000004,Aylesbury Vale,E12000008,South East,136235,106895,106833,52877,53956,62,0,25,2,35
E07000005,Chiltern,E12000008,South East,70185,58651,58604,32241,26363,47,0,15,0,32
E07000006,South Bucks,E12000008,South East,52194,40755,40724,20077,20647,31,0,10,5,16
E07000007,Wycombe,E12000008,South East,125260,94869,94790,49261,45529,79,0,26,1,52
E07000061,Eastbourne,E12000008,South East,71726,53598,53545,22845,30700,53,2,15,5,31
E07000062,Hastings,E12000008,South East,61957,44387,44350,20011,24339,37,0,12,4,21
E07000063,Lewes,E12000008,South East,76428,59531,59482,30974,28508,49,0,20,0,29
E07000064,Rother,E12000008,South East,72755,57715,57669,23916,33753,46,0,16,0,30
E07000065,Wealden,E12000008,South East,121141,96944,96892,44084,52808,52,1,16,0,35
E07000084,Basingstoke and Deane,E12000008,South East,128677,100395,100328,48257,52071,67,0,25,2,40
E07000085,East Hampshire,E12000008,South East,90588,73967,73922,37346,36576,45,0,12,1,32
E07000086,Eastleigh,E12000008,South East,97280,76148,76074,36172,39902,74,0,29,1,44
E07000087,Fareham,E12000008,South East,90175,71772,71735,32210,39525,37,0,9,4,24
E07000088,Gosport,E12000008,South East,62781,46150,46127,16671,29456,23,0,10,3,10
E07000089,Hart,E12000008,South East,69946,57827,57795,30282,27513,32,0,9,0,23
E07000090,Havant,E12000008,South East,95366,70670,70629,26582,44047,41,0,24,0,17
E07000091,New Forest,E12000008,South East,141061,111786,111740,47199,64541,46,0,8,2,36
E07000092,Rushmoor,E12000008,South East,65790,48800,48780,20384,28396,20,0,6,1,13
E07000093,Test Valley,E12000008,South East,94559,75316,75261,36170,39091,55,0,13,4,38
E07000094,Winchester,E12000008,South East,89595,72801,72764,42878,29886,37,0,12,2,23
E07000105,Ashford,E12000008,South East,90516,69827,69786,28314,41472,41,0,13,0,28
E07000106,Canterbury,E12000008,South East,109399,82105,82048,40169,41879,57,0,21,1,35
E07000107,Dartford,E12000008,South East,73951,55883,55855,19985,35870,28,0,9,1,18
E07000108,Dover,E12000008,South East,85011,65057,65016,24606,40410,41,0,10,0,31
E07000109,Gravesham,E12000008,South East,72808,54553,54519,18876,35643,34,0,6,0,28
E07000110,Maidstone,E12000008,South East,117298,89173,89127,36762,52365,46,3,8,1,34
E07000111,Sevenoaks,E12000008,South East,87253,70393,70349,32091,38258,44,0,18,4,22
E07000112,Shepway,E12000008,South East,80879,60659,60613,22884,37729,46,0,13,2,31
E07000113,Swale,E12000008,South East,102209,75913,75869,28481,47388,44,0,16,0,28
E07000114,Thanet,E12000008,South East,99108,72146,72102,26065,46037,44,0,14,1,29
E07000115,Tonbridge and Malling,E12000008,South East,93019,74066,74021,32792,41229,45,0,15,1,29
E07000116,Tunbridge Wells,E12000008,South East,82181,65039,64996,35676,29320,43,0,13,2,28
E07000177,Cherwell,E12000008,South East,108342,81908,81836,40668,41168,72,0,29,1,42
E07000178,Oxford,E12000008,South East,97331,70411,70337,49424,20913,74,0,29,1,44
E07000179,South Oxfordshire,E12000008,South East,104231,84167,84110,46245,37865,57,0,18,0,39
E07000180,Vale of White Horse,E12000008,South East,94487,76706,76654,43462,33192,52,0,13,0,39
E07000181,West Oxfordshire,E12000008,South East,82441,65719,65671,35236,30435,48,0,8,1,39
E07000207,Elmbridge,E12000008,South East,98613,77058,77003,45841,31162,55,0,16,3,36
E07000208,Epsom and Ewell,E12000008,South East,56382,45343,45303,23596,21707,40,0,11,5,24
E07000209,Guildford,E12000008,South East,102209,78657,78613,44155,34458,44,0,19,6,19
E07000210,Mole Valley,E12000008,South East,66730,54829,54796,29088,25708,33,0,11,0,22
E07000211,Reigate and Banstead,E12000008,South East,103731,81200,81161,40181,40980,39,1,9,1,28
E07000212,Runnymede,E12000008,South East,58272,44326,44294,20259,24035,32,0,10,2,20
E07000213,Spelthorne,E12000008,South East,72674,56638,56609,22474,34135,29,0,13,2,14
E07000214,Surrey Heath,E12000008,South East,65569,52330,52305,25638,26667,25,0,8,1,16
E07000215,Tandridge,E12000008,South East,64044,51466,51420,24251,27169,46,0,16,0,30
E07000216,Waverley,E12000008,South East,92291,75999,75942,44341,31601,57,0,19,1,37
E07000217,Woking,E12000008,South East,71313,55261,55221,31007,24214,40,0,18,1,21
E07000223,Adur,E12000008,South East,48755,37251,37229,16914,20315,22,0,8,0,14
E07000224,Arun,E12000008,South East,117138,91199,91129,34193,56936,70,0,22,2,46
E07000225,Chichester,E12000008,South East,91659,71407,71337,35011,36326,70,3,27,1,39
E07000226,Crawley,E12000008,South East,73575,53884,53835,22388,31447,49,0,19,9,21
E07000227,Horsham,E12000008,South East,104270,85132,85088,43785,41303,44,2,16,5,21
E07000228,Mid Sussex,E12000008,South East,108416,87588,87528,46471,41057,60,0,40,2,18
E07000229,Worthing,E12000008,South East,81384,61416,61366,28851,32515,50,0,11,1,38
E06000022,Bath and North East Somerset,E12000009,South West,136522,105300,105230,60878,44352,70,0,20,5,45
E06000023,"Bristol, City of",E12000009,South West,312465,228646,228445,141027,87418,201,0,63,6,132
E06000024,North Somerset,E12000009,South West,160860,124622,124548,59572,64976,74,0,33,0,41
E06000025,South Gloucestershire,E12000009,South West,207793,158427,158333,74928,83405,94,0,28,4,62
E06000026,Plymouth,E12000009,South West,186989,133523,133455,53458,79997,68,1,18,1,48
E06000027,Torbay,E12000009,South West,102961,75868,75824,27935,47889,44,0,18,0,26
E06000028,Bournemouth,E12000009,South West,132752,91997,91926,41473,50453,71,0,31,1,39
E06000029,Poole,E12000009,South West,113421,85493,85448,35741,49707,45,2,12,0,31
E06000030,Swindon,E12000009,South West,148960,113060,112965,51220,61745,95,0,33,5,57
E06000052,Cornwall,E12000009,South West,419755,323442,323205,140540,182665,237,0,71,0,166
E06000053,Isles of Scilly,E12000009,South West,1799,1424,1424,803,621,0,0,0,0,0
E06000054,Wiltshire,E12000009,South West,366555,289102,288895,137258,151637,207,0,70,9,128
E07000040,East Devon,E12000009,South West,112527,88831,88783,40743,48040,48,0,23,0,25
E07000041,Exeter,E12000009,South West,86417,63867,63803,35270,28533,64,0,19,3,42
E07000042,Mid Devon,E12000009,South West,60532,48049,48006,22400,25606,43,0,7,3,33
E07000043,North Devon,E12000009,South West,75548,58056,58031,24931,33100,25,0,10,1,14
E07000044,South Hams,E12000009,South West,69121,55485,55450,29308,26142,35,0,15,0,20
E07000045,Teignbridge,E12000009,South West,103740,82369,82312,37949,44363,57,0,19,0,38
E07000046,Torridge,E12000009,South West,52881,41462,41429,16229,25200,33,0,11,1,21
E07000047,West Devon,E12000009,South West,43823,35612,35595,16658,18937,17,0,5,1,11
E07000048,Christchurch,E12000009,South West,39176,31066,31050,12782,18268,16,0,6,2,8
E07000049,East Dorset,E12000009,South West,71966,58530,58488,24786,33702,42,0,12,2,28
E07000050,North Dorset,E12000009,South West,52980,42228,42201,18399,23802,27,0,0,0,27
E07000051,Purbeck,E12000009,South West,36418,28736,28720,11754,16966,16,0,6,0,10
E07000052,West Dorset,E12000009,South West,82071,65237,65191,31924,33267,46,0,14,1,31
E07000053,Weymouth and Portland,E12000009,South West,50442,38271,38255,14903,23352,16,0,6,0,10
E07000078,Cheltenham,E12000009,South West,87060,66057,66013,37081,28932,44,0,18,2,24
E07000079,Cotswold,E12000009,South West,68734,54847,54821,28015,26806,26,0,10,2,14
E07000080,Forest of Dean,E12000009,South West,66705,51677,51643,21392,30251,34,0,17,1,16
E07000081,Gloucester,E12000009,South West,89661,64606,64577,26801,37776,29,0,14,1,14
E07000082,Stroud,E12000009,South West,92631,74128,74064,40446,33618,64,0,20,5,39
E07000083,Tewkesbury,E12000009,South West,67831,53686,53652,25084,28568,34,0,16,2,16
E07000187,Mendip,E12000009,South West,85068,65509,65455,33427,32028,54,0,16,5,33
E07000188,Sedgemoor,E12000009,South West,89714,68450,68414,26545,41869,36,1,13,1,21
E07000189,South Somerset,E12000009,South West,126495,99535,99467,42527,56940,68,0,22,0,46
E07000190,Taunton Deane,E12000009,South West,84164,65786,65733,30944,34789,53,0,21,1,31
E07000191,West Somerset,E12000009,South West,27478,21753,21734,8566,13168,19,1,10,0,8
GI,Gibraltar,E12000009,South West,24119,20172,20145,19322,823,27,0,8,0,19
W06000001,Isle of Anglesey,W92000004,Wales,51445,37978,37951,18618,19333,27,0,11,0,16
W06000002,Gwynedd,W92000004,Wales,84575,61245,61182,35517,25665,63,14,17,2,30
W06000003,Conwy,W92000004,Wales,91368,65554,65504,30147,35357,50,0,19,0,31
W06000004,Denbighshire,W92000004,Wales,75362,52108,52072,23955,28117,36,1,10,0,25
W06000005,Flintshire,W92000004,Wales,115964,86854,86797,37867,48930,57,0,22,2,33
W06000006,Wrexham,W92000004,Wales,98384,70407,70366,28822,41544,41,0,17,0,24
W06000008,Ceredigion,W92000004,Wales,53400,39772,39742,21711,18031,30,0,8,1,21
W06000009,Pembrokeshire,W92000004,Wales,92155,68555,68522,29367,39155,33,0,15,0,18
W06000010,Carmarthenshire,W92000004,Wales,139227,103126,103035,47654,55381,91,0,30,0,61
W06000011,Swansea,W92000004,Wales,172941,120362,120243,58307,61936,119,0,52,3,64
W06000012,Neath Port Talbot,W92000004,Wales,105766,75694,75652,32651,43001,42,1,17,0,24
W06000013,Bridgend,W92000004,Wales,104492,74378,74345,33723,40622,33,0,12,1,20
W06000014,Vale of Glamorgan,W92000004,Wales,95011,72348,72309,36681,35628,39,0,12,0,27
W06000015,Cardiff,W92000004,Wales,243689,169745,169604,101788,67816,141,0,56,3,82
W06000016,Rhondda Cynon Taf,W92000004,Wales,172890,116645,116563,53973,62590,82,0,34,0,48
W06000018,Caerphilly,W92000004,Wales,130801,92525,92473,39178,53295,52,1,19,3,29
W06000019,Blaenau Gwent,W92000004,Wales,51136,34812,34802,13215,21587,10,0,3,0,7
W06000020,Torfaen,W92000004,Wales,68957,48172,48144,19363,28781,28,0,11,2,15
W06000021,Monmouthshire,W92000004,Wales,71607,55670,55630,28061,27569,40,19,0,0,21
W06000022,Newport,W92000004,Wales,104977,73708,73649,32413,41236,59,3,29,2,25
W06000023,Powys,W92000004,Wales,103270,79515,79469,36762,42707,46,0,17,7,22
W06000024,Merthyr Tydfil,W92000004,Wales,42855,28881,28865,12574,16291,16,0,7,1,8
E06000019,"Herefordshire, County of",E12000005,West Midlands,138247,108336,108270,44148,64122,66,0,22,1,43
E06000020,Telford and Wrekin,E12000005,West Midlands,124338,89704,89603,32954,56649,101,0,11,0,90
E06000021,Stoke-on-Trent,E12000005,West Midlands,179010,117674,117590,36027,81563,84,0,19,6,59
E06000051,Shropshire,E12000005,West Midlands,236788,183323,183153,78987,104166,170,0,42,0,128
E07000192,Cannock Chase,E12000005,West Midlands,75010,53607,53578,16684,36894,29,0,15,2,12
E07000193,East Staffordshire,E12000005,West Midlands,83558,62161,62116,22850,39266,45,0,9,1,35
E07000194,Lichfield,E12000005,West Midlands,80369,63318,63278,26064,37214,40,0,16,1,23
E07000195,Newcastle-under-Lyme,E12000005,West Midlands,92816,68966,68934,25477,43457,32,0,13,0,19
E07000196,South Staffordshire,E12000005,West Midlands,85777,66739,66692,23444,43248,47,0,6,2,39
E07000197,Stafford,E12000005,West Midlands,99612,77527,77484,34098,43386,43,0,11,3,29
E07000198,Staffordshire Moorlands,E12000005,West Midlands,79347,59793,59760,21076,38684,33,0,13,0,20
E07000199,Tamworth,E12000005,West Midlands,56825,42151,42129,13705,28424,22,0,12,0,10
E07000218,North Warwickshire,E12000005,West Midlands,49790,37975,37954,12569,25385,21,0,9,0,12
E07000219,Nuneaton and Bedworth,E12000005,West Midlands,93978,69876,69831,23736,46095,45,0,20,2,23
E07000220,Rugby,E12000005,West Midlands,74137,58593,58549,25350,33199,44,0,13,2,29
E07000221,Stratford-on-Avon,E12000005,West Midlands,98014,79217,79158,38341,40817,59,0,9,0,50
E07000222,Warwick,E12000005,West Midlands,103099,81680,81618,47976,33642,62,0,33,0,29
E07000234,Bromsgrove,E12000005,West Midlands,74170,58855,58815,26252,32563,40,0,11,2,27
E07000235,Malvern Hills,E12000005,West Midlands,60217,48538,48497,23203,25294,41,0,10,0,31
E07000236,Redditch,E12000005,West Midlands,61038,45912,45882,17303,28579,30,0,7,0,23
E07000237,Worcester,E12000005,West Midlands,73516,54290,54239,25125,29114,51,7,22,2,20
E07000238,Wychavon,E12000005,West Midlands,94497,76425,76389,32188,44201,36,0,15,0,21
E07000239,Wyre Forest,E12000005,West Midlands,77878,57666,57632,21240,36392,34,0,6,0,28
E08000025,Birmingham,E12000005,West Midlands,707293,451316,450702,223451,227251,614,0,311,17,286
E08000026,Coventry,E12000005,West Midlands,221389,153234,153064,67967,85097,170,0,85,0,85
E08000027,Dudley,E12000005,West Midlands,244516,175333,175226,56780,118446,107,0,41,2,64
E08000028,Sandwell,E12000005,West Midlands,221429,147418,147254,49004,98250,164,0,90,2,72
E08000029,Solihull,E12000005,West Midlands,160425,122020,121950,53466,68484,70,0,25,0,45
E08000030,Walsall,E12000005,West Midlands,194729,135685,135579,43572,92007,106,0,59,3,44
E08000031,Wolverhampton,E12000005,West Midlands,174760,118037,117936,44138,73798,101,0,45,7,49
E06000010,"Kingston upon Hull, City of",E12000003,Yorkshire and The Humber,180230,113436,113355,36709,76646,81,0,23,4,54
E06000011,East Riding of Yorkshire,E12000003,Yorkshire and The Humber,266047,199036,198915,78779,120136,121,0,36,3,82
E06000012,North East Lincolnshire,E12000003,Yorkshire and The Humber,116302,79011,78982,23797,55185,29,1,4,1,23
E06000013,North Lincolnshire,E12000003,Yorkshire and The Humber,123611,88906,88862,29947,58915,44,0,11,3,30
E06000014,York,E12000003,Yorkshire and The Humber,155157,109681,109600,63617,45983,81,0,20,5,56
E07000163,Craven,E12000003,Yorkshire and The Humber,44320,35907,35891,16930,18961,16,0,6,0,10
E07000164,Hambleton,E12000003,Yorkshire and The Humber,70133,55016,54982,25480,29502,34,0,18,1,15
E07000165,Harrogate,E12000003,Yorkshire and The Humber,119987,94653,94585,48211,46374,68,2,25,3,38
E07000166,Richmondshire,E12000003,Yorkshire and The Humber,36794,27652,27636,11945,15691,16,0,6,0,10
E07000167,Ryedale,E12000003,Yorkshire and The Humber,41529,32069,32050,14340,17710,19,0,5,2,12
E07000168,Scarborough,E12000003,Yorkshire and The Humber,82900,60539,60511,22999,37512,28,0,6,0,22
E07000169,Selby,E12000003,Yorkshire and The Humber,65278,51636,51603,21071,30532,33,0,7,2,24
E08000016,Barnsley,E12000003,Yorkshire and The Humber,175809,122972,122909,38951,83958,63,0,17,1,45
E08000017,Doncaster,E12000003,Yorkshire and The Humber,217432,151246,151182,46922,104260,64,0,19,0,45
E08000018,Rotherham,E12000003,Yorkshire and The Humber,197623,137470,137387,44115,93272,83,0,30,4,49
E08000019,Sheffield,E12000003,Yorkshire and The Humber,396406,266951,266753,130735,136018,198,0,76,6,116
E08000032,Bradford,E12000003,Yorkshire and The Humber,342817,228727,228488,104575,123913,239,0,121,5,113
E08000033,Calderdale,E12000003,Yorkshire and The Humber,149195,106004,105925,46950,58975,79,0,22,15,42
E08000034,Kirklees,E12000003,Yorkshire and The Humber,307081,217428,217240,98485,118755,188,0,86,7,95
E08000035,Leeds,E12000003,Yorkshire and The Humber,543033,387677,387337,194863,192474,340,39,116,8,177
E08000036,Wakefield,E12000003,Yorkshire and The Humber,246096,175155,175042,58877,116165,113,0,46,4,63
